#persistence_modellist.txt
#do/persistence_model_reg7_arts_enfr.txt	arts_enfr	Arts Faculty -- English or French Grade
#do/persistence_model_reg7_arts_enfr_fall.txt	arts_enfr_fall	Arts Faculty -- English or French Grade -- Fall Y1 Only
#do/persistence_model_reg7_arts_enfr_y1.txt	arts_enfr_y1	Arts Faculty -- English or French Grade -- Y1 Only
#do/persistence_model_reg7_arts_phil.txt	arts_phil	Arts Faculty -- Philosophy Grade
#do/persistence_model_reg7_arts_phil_fall.txt	arts_phil_fall	Arts Faculty -- Philosophy Grade -- Fall Y1 Only
#do/persistence_model_reg7_arts_phil_y1.txt	arts_phil_y1	Arts Faculty -- Philosophy Grade -- Y1 Only
#do/persistence_model_reg7_genie_enfr.txt	genie_enfr	Engineering Faculty -- English or French Grade
#do/persistence_model_reg7_genie_enfr_fall.txt	genie_enfr_fall	Engineering Faculty -- English or French Grade -- Fall Y1 Only
#do/persistence_model_reg7_genie_enfr_y1.txt	genie_enfr_y1	Engineering Faculty -- English or French Grade -- Y1 Only
#do/persistence_model_reg7_genie_math.txt	genie_math	Engineering Faculty -- Math Grade
#do/persistence_model_reg7_genie_math_fall.txt	genie_math_fall	Engineering Faculty -- Math Grade -- Fall Y1 Only
#do/persistence_model_reg7_genie_math_y1.txt	genie_math_y1	Engineering Faculty -- Math Grade -- Y1 Only
#do/persistence_model_reg7_scien_enfr.txt	scien_enfr	Science Faculty -- English or French Grade
#do/persistence_model_reg7_scien_enfr_fall.txt	scien_enfr_fall	Science Faculty -- English or French Grade -- Fall Y1 Only
#do/persistence_model_reg7_scien_enfr_y1.txt	scien_enfr_y1	Science Faculty -- English or French Grade -- Y1 Only
#do/persistence_model_reg7_scien_math.txt	scien_math	Science Faculty -- Math Grade
#do/persistence_model_reg7_scien_math_fall.txt	scien_math_fall	Science Faculty -- Math Grade -- Fall Y1 Only
#do/persistence_model_reg7_scien_math_y1.txt	scien_math_y1	Science Faculty -- Math Grade -- Y1 Only
#do/persistence_model_reg7_ssan_enfr.txt	ssan_enfr	Health Faculty -- English or French Grade
#do/persistence_model_reg7_ssan_enfr_fall.txt	ssan_enfr_fall	Health Faculty -- English or French Grade -- Fall Y1 Only
#do/persistence_model_reg7_ssan_enfr_y1.txt	ssan_enfr_y1	Health Faculty -- English or French Grade -- Y1 Only
#do/persistence_model_reg7_ssoc_enfr.txt	ssoc_enfr	Social Science Faculty -- English or French Grade
#do/persistence_model_reg7_ssoc_enfr_fall.txt	ssoc_enfr_fall	Social Science Faculty -- English or French Grade -- Fall Y1 Only
#do/persistence_model_reg7_ssoc_enfr_y1.txt	ssoc_enfr_y1	Social Science Faculty -- English or French Grade -- Y1 Only
do/persistence_model_reg8.txt	backgr_all	Background Variables -- All Observations
do/persistence_model_reg8_female.txt	backgr_female	Background Variables -- Females
do/persistence_model_reg8_male.txt	backgr_male	Background Variables -- Males
do/persistence_model_reg8_local.txt	backgr_local	Background Variables -- Local
do/persistence_model_reg8_nonlocal.txt	backgr_nonlocal	Background Variables -- Non-Local
do/persistence_model_reg8_rural.txt	backgr_rural	Background Variables -- Rural
do/persistence_model_reg8_urban.txt	backgr_urban	Background Variables -- Urban
do/persistence_model_reg9.txt	local_all	Background Variables and Local -- All Observations
do/persistence_model_reg9_female.txt	local_female	Background Variables and Local -- Females
do/persistence_model_reg9_male.txt	local_male	Background Variables and Local -- Males
do/persistence_model_reg9_rural.txt	local_rural	Background Variables and Local -- Rural Students
do/persistence_model_reg9_urban.txt	local_urban	Background Variables and Local -- Urban Students
do/persistence_model_reg10.txt	regions_all	Background Variables and Regions -- All Observations
do/persistence_model_reg10_female.txt	regions_female	Background Variables and Regions -- Females
do/persistence_model_reg10_male.txt	regions_male	Background Variables and Regions - Males
do/persistence_model_reg10_nonlocal.txt	regions_nonlocal	Background Variables and Regions -- Non-Local
do/persistence_model_reg10_rural.txt	regions_rural	Background Variables and Regions -- Rural
do/persistence_model_reg10_urban.txt	regions_urban	Background Variables and Regions -- Urban
do/persistence_model_reg11.txt	local_linear	Local Variable and Linear Grade Variables
do/persistence_model_reg12.txt	regions_linear	Region Variables and Linear Grade Variables
do/persistence_model_reg13_arts_enfr.txt	lin_arts_enfr	Arts Faculty -- English or French Grade -- Linear
do/persistence_model_reg13_arts_phil.txt	lin_arts_phil	Arts Faculty -- Philospohy Grade -- Linear
do/persistence_model_reg13_genie_enfr.txt	lin_genie_enfr	Engineering Faculty -- English or French Grade -- Linear
do/persistence_model_reg13_genie_math.txt	lin_genie_math	Engineering Faculty -- Math Grade -- Linear
do/persistence_model_reg13_scien_enfr.txt	lin_scien_enfr	Science Faculty -- English or French Grade -- Linear
do/persistence_model_reg13_scien_math.txt	lin_scien_math	Science Faculty -- Math Grade -- Linear
do/persistence_model_reg13_ssan_enfr.txt	lin_scien_enfr	Health Faculty -- English or French Grade -- Linear
do/persistence_model_reg13_ssoc_enfr.txt	lin_ssoc_enfr	Social Science Faculty -- English or French Grade -- Linear
do/persistence_model_reg14_arts_enfr.txt	fail_arts_enfr	Arts Faculty -- Failed English or French Course 
do/persistence_model_reg14_arts_phil.txt	fail_arts_phil	Arts Faculty -- Failed Philosophy Course
do/persistence_model_reg14_genie_enfr.txt	fail_genie_enfr	Engineering Faculty -- Failed English or French Course
do/persistence_model_reg14_genie_math.txt	fail_genie_math	Engineering Faculty -- Failed Math Course
do/persistence_model_reg14_scien_enfr.txt	fail_scien_enfr	Science Faculty -- Failed English or French Course
do/persistence_model_reg14_scien_math.txt	fail_scien_math	Science Faculty -- Failed Math Course
do/persistence_model_reg14_ssan_enfr.txt	fail_ssan_enfr	Health Faculty -- Failed English or French Course
do/persistence_model_reg14_ssoc_enfr.txt	fail_ssoc_enfr	Social Science Faculty -- Failed English or French Course

